5 5 1 3 3 4
0 1 0 0 0
0 1 0 1 0
0 1 0 0 0
0 0 0 1 0
0 1 0 1 0
